31 41
5 5 5 5 5 5 5 5 5 5 5 5 5 5 5 5 5 5 5 5 5 5 5 5 5 5 5 5 5 5 5 5 5 5 5 5 5 5 5 5 5
5 0 0 0 0 0 0 0 0 0 0 0 0 0 0 0 0 0 0 0 0 0 0 0 0 0 0 0 0 0 0 0 0 0 0 0 0 0 0 0 5
5 0 5 5 5 5 5 0 0 5 5 5 0 0 0 5 5 5 5 0 0 0 0 0 5 5 0 5 5 0 0 5 5 5 0 0 5 5 0 0 5
5 0 5 1 1 1 5 0 5 1 1 1 5 0 5 0 0 0 0 0 0 0 0 0 5 5 5 5 5 0 5 1 1 1 5 0 5 5 0 0 5
5 0 5 1 1 1 5 0 5 1 1 1 5 0 5 0 0 0 0 0 0 0 0 0 5 0 5 0 5 0 5 1 1 1 5 0 5 0 5 0 5
5 0 5 5 5 5 5 0 5 5 5 5 5 0 5 0 0 0 0 0 5 5 5 0 5 0 0 0 5 0 5 5 5 5 5 0 5 0 5 0 5
5 0 5 0 0 0 0 0 5 0 0 0 5 0 5 0 0 0 0 0 0 0 0 0 5 0 0 0 5 0 5 0 0 0 5 0 5 0 5 0 5
5 0 5 0 0 0 0 0 5 0 0 0 5 0 5 0 0 0 0 0 0 0 0 0 5 0 0 0 5 0 5 0 0 0 5 0 5 0 0 5 5
5 0 5 0 0 0 0 0 5 0 0 0 5 0 0 5 5 5 5 0 0 0 0 0 5 0 0 0 5 0 5 0 0 0 5 0 5 0 0 5 5
5 0 0 0 5 5 5 0 0 0 5 0 0 0 0 0 0 0 0 0 5 5 5 0 0 0 5 0 0 0 0 0 5 0 0 0 0 0 0 0 5
5 0 5 5 5 5 5 5 5 5 5 5 5 5 5 0 5 5 5 0 5 5 5 0 5 5 5 5 5 5 5 5 5 5 5 5 5 5 5 0 5
5 0 5 5 5 5 5 5 5 5 5 5 5 5 5 0 5 5 5 0 5 5 5 0 5 5 5 5 5 5 5 5 5 5 5 5 5 5 5 0 5
5 0 0 0 0 0 0 0 0 0 0 0 0 0 0 0 1 1 1 1 1 1 1 1 1 0 0 0 0 0 0 0 0 0 0 0 0 0 0 0 5
5 0 5 5 5 5 5 5 5 0 5 5 5 5 5 0 5 1 5 5 5 5 5 1 5 0 5 5 5 5 5 0 5 5 5 5 5 5 5 0 5
5 0 5 5 5 5 5 5 5 0 5 5 5 5 5 0 5 1 5 3 3 3 5 1 5 0 5 5 5 5 5 0 5 5 5 5 5 5 5 0 5
5 0 0 0 0 0 0 0 0 0 0 0 0 0 0 0 5 1 5 5 4 5 5 1 5 0 0 0 0 0 0 0 0 0 0 0 0 0 0 0 5
5 5 5 5 5 5 5 0 5 5 5 5 5 5 5 0 1 1 1 1 1 1 1 1 1 0 5 5 5 5 5 5 5 0 5 5 5 5 5 5 5
5 0 0 0 0 0 0 0 0 0 0 0 0 0 0 0 5 5 5 5 5 5 5 5 5 0 0 0 0 0 0 0 0 0 0 0 0 0 0 0 5
5 0 5 5 5 5 5 5 5 5 5 5 5 5 5 0 0 0 0 0 0 0 0 0 0 0 5 5 5 5 5 5 5 5 5 5 5 5 5 0 5
5 0 0 0 0 0 0 0 0 0 0 0 0 0 5 0 5 5 5 5 5 5 5 5 5 0 5 1 1 1 1 1 1 1 1 1 1 1 5 0 5
5 0 0 0 0 0 0 0 0 0 0 0 0 0 5 0 5 5 5 5 5 5 5 5 5 0 5 1 1 1 1 1 1 1 1 1 1 1 5 0 5
5 0 0 0 0 0 0 0 0 0 0 0 0 0 5 0 0 5 5 5 5 5 5 5 0 0 5 1 1 1 1 1 1 1 1 1 1 1 5 0 5
5 0 0 0 0 0 0 0 0 0 0 0 0 0 5 0 5 5 5 5 5 5 5 5 5 0 5 1 1 1 1 1 1 1 1 1 1 1 5 0 5
5 0 5 5 5 5 5 5 5 5 5 5 5 5 5 0 5 5 5 5 5 5 5 5 5 0 5 1 1 1 1 1 1 1 1 1 1 1 5 0 5
5 0 5 0 0 0 0 0 0 0 0 0 0 0 0 0 0 0 0 0 0 0 0 0 0 0 5 1 1 1 1 1 1 1 1 1 1 1 5 0 5
5 0 5 0 0 0 0 0 0 0 0 0 0 0 0 0 0 0 5 5 5 5 5 0 0 0 5 1 1 1 1 1 1 1 1 1 1 1 5 0 5
5 0 5 0 0 0 0 0 0 0 0 0 0 0 0 0 0 0 5 5 5 5 5 0 0 0 5 1 1 1 1 1 1 1 1 1 1 1 5 0 5
5 0 5 0 0 0 0 0 0 0 0 0 0 0 0 0 0 0 5 5 5 5 5 0 0 0 5 1 1 1 1 1 1 1 1 1 1 1 5 0 5
5 0 5 5 5 5 5 5 5 5 5 5 5 5 5 0 0 0 5 5 5 5 5 0 0 0 5 5 5 5 5 5 5 5 5 5 5 5 5 0 5
5 0 0 0 0 0 0 0 0 0 0 0 0 0 0 0 0 0 0 0 2 0 0 0 0 0 0 0 0 0 0 0 0 0 0 0 0 0 0 0 5
5 5 5 5 5 5 5 5 5 5 5 5 5 5 5 5 5 5 5 5 5 5 5 5 5 5 5 5 5 5 5 5 5 5 5 5 5 5 5 5 5